-> Todas as propriedades background do CSS
background	Sets all the background properties in one declaration
background-attachment	Sets whether a background image is fixed or scrolls with the rest of the page
background-clip	Specifies the painting area of the background
background-color	Sets the background color of an element
background-image	Sets the background image for an element
background-origin	Specifies where the background image(s) is/are positioned
background-position	Sets the starting position of a background image
background-repeat	Sets how a background image will be repeated
background-size	Specifies the size of the background image(s)

-> Como funciona a configuração de valores para os estilos de borda?
If the border-style property has four values:

border-style: dotted solid double dashed;
top border is dotted
right border is solid
bottom border is double
left border is dashed
If the border-style property has three values:

border-style: dotted solid double;
top border is dotted
right and left borders are solid
bottom border is double
If the border-style property has two values:

border-style: dotted solid;
top and bottom borders are dotted
right and left borders are solid
If the border-style property has one value:

border-style: dotted;
all four borders are dotted
The border-style property is used in the example above. However, it also works with border-width and border-color.

-> Todas as propriedades de borda em CSS:
border	Sets all the border properties in one declaration
border-bottom	Sets all the bottom border properties in one declaration
border-bottom-color	Sets the color of the bottom border
border-bottom-style	Sets the style of the bottom border
border-bottom-width	Sets the width of the bottom border
border-color	Sets the color of the four borders
border-left	Sets all the left border properties in one declaration
border-left-color	Sets the color of the left border
border-left-style	Sets the style of the left border
border-left-width	Sets the width of the left border
border-radius	Sets all the four border-*-radius properties for rounded corners
border-right	Sets all the right border properties in one declaration
border-right-color	Sets the color of the right border
border-right-style	Sets the style of the right border
border-right-width	Sets the width of the right border
border-style	Sets the style of the four borders
border-top	Sets all the top border properties in one declaration
border-top-color	Sets the color of the top border
border-top-style	Sets the style of the top border
border-top-width	Sets the width of the top border
border-width	Sets the width of the four borders

-> Todas as propriedades Margin em CSS:
margin	A shorthand property for setting the margin properties in one declaration
margin-bottom	Sets the bottom margin of an element
margin-left	Sets the left margin of an element
margin-right	Sets the right margin of an element
margin-top	Sets the top margin of an element

-> Todas as propriedades de padding em CSS
padding	A shorthand property for setting all the padding properties in one declaration
padding-bottom	Sets the bottom padding of an element
padding-left	Sets the left padding of an element
padding-right	Sets the right padding of an element
padding-top	Sets the top padding of an element

-> Todas as propriedades de dimensão do CSS
height	Sets the height of an element
max-height	Sets the maximum height of an element
max-width	Sets the maximum width of an element
min-height	Sets the minimum height of an element
min-width	Sets the minimum width of an element
width	Sets the width of an element